S....###.#....###..#..#..#.##.#......#.##..#.........###.#.#..####..##..#.....#....#..#...###..##...
###..##...##....##...##.###..#...#.#..#.....#...##..#.....#.####...#.......##.##....##....##.......#
....#...#..###.#......##....#....#.....#..#.#.##.#.#...##....#......#..#.#..#...#..#..#..##.####....
#......#..#.......#.........##......#..............#......#....#..##..##.#......#..#.###...#.#..###.
......##...#...#............#..#....#.....##.##.#......#.##....#...#..##..#.#......#....#....###.#..
..#...#..#.#....#.#..#.......#..#.....##.#.#.###......##.....#...#......#.....##..#..#....##........
###.###....#..#..#..#..#....##...##.....#.#.#.###.#.........#.#..#.......#...#.#..#..#........#...#.
#......#..#.#..#.#..##.#..#....#....#.#.....#.....##.......#.##.##..#..........#.#....#....#...#....
..##......###.#.##.#..#..#..........#....##.#....#...#.#.......##..#.####.....###.##.##.###.#.#...#.
.#.##..##....####.#...#.###.#..###.....###..##..##.##.....#.....##.#.#..#...#.#..#..#....#######...#
....#..#......#..#.#..####.##..#.#.#.........#....#....#.##.###.#...#......#.....###.#.#.....#....##
.....#.##.#.#..#..##..####....#.....###....#.....#.####.#.#.####..##....#...##.#............#...###.
.#..#...........##..##.#..#.........####....###..##..#.##...#..###.#...#.....##.#....#.#...#.....#..
...#.#....####.....#.#............#......#.###..#.##.#......##.#...##.#.#.##..#..#.#..####..##......
#..#..##..#.#.....#...#.#.#......##.#.#.##...##..###.#..#..##.#.#....##.##......#.####.....#..#.#...
####..#.##.#....##.##.#.#.#.#....##.#.#.#....#.##.##............#.#..#.##.#..###..###.#.##..#...#...
.###....###..#...#..#.##..#......##...#..##....##..#...#..#....#..#.##.....##.#........##..#.....##.
...#.......#....#.###.#..................#...#.#....#.#.#.....#.#.......#.#......##...#.#..##.##...#
#...#....#.#.#..#.#...##...##.###.##.....#.......#..##....#...#...###.#.#......#.....#.......##.....
#.....#........#......##.....##...#.##.......####..#.##.#...##...#.#.#.....#.....#....#.#.....##...#
.......#..##....#...###...##..#.#......##.......##.#..#...#....#.#.....##.#..##.#...#....#..#.#...##
.#.....##.#....#......#..#.###...#..##...#.#.....##..#....#####.##...#.#.......#...#.#..##......#...
.#...###......###...##.#..##..##.....##.#...##..#..#........#..#..##....#.#..#..#....#..#.#..##.#..#
##..#.##....#.#..#....##....#.#..#..#......#.#...#..#..####..###..#...#.#....#.#..#......#......#.#.
##..#.##..#.##.#...#.#..#.#......#.........#.#....#..#..#............#.#..#.#....#.##......#.#.#....
...#......#.#.#.#.....###.###....#...#.......#.#.#..#.#...##.....##.####.#.####.#...##..##.....#...#
#..##...#....#..##.#..#......##....#.#........#........#...##..#...##..#...#.#...###.##......##.##.#
#.......####..#..#..#.###...#..#..#..#.##........#.#.......##...####...#.......#..#......#.#.#.##..#
#.#.....#..###.#..#.#...#...#...#..#...#..#.......##.#...#..........#.#.#.#...#....####.#.#..###....
......#....##........#...##..#.....#..........#.#.###..##..#..#...##..#####..###.#...#........##..##
#...#.#.#....###.....###..#..####..#.####.#.#..#.#...######.......#..........#....##....#...##......
.#...##..###.####..#......#.#..#.....#.....##.....#.##...###...##..#..#.#.##.....##....#.##..#.#..#.
..#....#.......###.......#..#.........#...#.....#.#....###...#.#.#...##.#........#.#......#.........
#...#.#..........##....#.#.....#.#..#...##...#.#..#...##..#.#.##.#.....#..#.#..#..##.#.##.#...####..
#.##...#..#.#....##.#.#.......#.#.#...#..###.###.##..#.........###.#....#..#..........#..##....#.###
##.......#..........##..#.....##..........#...#..#.....#.#.......#..##...#..##.##..#..#....#.##.##.#
#..##.#.....#..#.....####....#.#......#.#....#.#..#.....##..#####.......#..#...#.#..##.....#..#.#.#.
........##.#.#.#...#.####.......#..##.....##..#.##...#.###......#..#....##...##.###....#..#.#.###.#.
.#....###..#..#....#..##.........#.##.....#...##....##.......##...####...###......#..#.....#.#...#..
##...##....#.#...#......#....#.....##....#..##.#.#......###.#.#.#...#..#.#.#..###......#.##.....#.#.
...........#..#..#.#.#.#..#.##.......#....#####..#..#.....##..##.####...........####...#.#.....#..#.
........#.##..#....#.#.#......#.#....#.#..#..#.#......##.........#..#.....#..#.....#.##...#.#.#.#..#
#....#.#...#........#.###...#.#....#.##.#.#...#......##......###....####..#.#...#..#........##.....#
.........#.###..#..#.#.#..##.##......####.##...........#..####...#.##.#.#........###.....##..#......
#....##...##..#.#..###..#....#.#.#..#.##.#...#...#.....#......#....#.....##......#.#.##.....##..###.
#.#.#..........#.#.##.....#..#.##.........#.##...##..###.#.#...##..#.#.....##.##....#.....#..##..#..
#....####.#..........###..####.#..##.......#...###..##..###..####...###..#....#.#....#..#..#......#.
#.#####.#......##.#..##.....#............#........##..#.##...#..#..#..#......#.....#.##....#..#..###
#...####.#...#..#..#..#.........###.#..#....##.#..#...#.....##.#..#.##......#....#.###..#...#####...
.#........##..#..##.#.......#.....#..#..#.#....##.#.#.#.#.#...##.#.#.....#.#..........#.##.....#####
#.#...#.#.#.......###..##......#......##....#.###.......##.#..##..............#...#.....##....#.#.#.
....#.#....#####.#...#..##......###....#....######.....#.#.#..............#.#.#.#......#.##.#.......
...###....#..........###..#..#.#.#.................###...###...#.#.#.#.##........##....#.#....##.#..
...#...##...#...#..##...#......#.##...##..#..##.#.#......####.#..#..........#.##..###...#.#.........
.###...#.###.#..#....###..#...##..#.#....#..#.....#.#.........#####.....#...#.###..#.#.#.#####.#.#..
.....#..#...#.#...##.#....##..##.#...#.#...........#..#....##.##.###...##...###..........#.....#..#.
.#...##.....#.....##...#....###..##..#...#.#..##.#.....##.#.##..#.#...#.#..#...#.#...#.#...##.#...##
#...##...###.#............#...#......#.####.#...#.##.#.#.#.#.#..##...#...#...##.#.##.#.#...##...#.#.
....##.#.......#.##.#####...###......#..#......#..#....###..#..#.##.#.#.#.#..#..##....#.#...##......
.#.#.#.#.#...#.##........#...#..#.##.#.#.#..#.........##....#..#...#.#...##...#...##..#.#....##..#..
.#..#.###.#.#.###..#...#........#.#...#.....##......##....#.#....#...#....###..#.##......#....#####.
..........####....#....#.#...#...#..##......#....#.........#......#..#..###...##.######..#.....##...
#.###....###..##.#..#..#.......#...#.##......#..#.#.#.##.##...#.#.#.######.#..#....#.#.#.#.###.###..
...#...#.#...##.###.##.....#.#.....#.#...#.###.....##..####....#...#.....#.##.#.##..#.##.#....#.#..#
.#.#....#.#......##..#....#..........#.#...#..#...#....#..#.#.##.....##..##...##.......#.##...#..###
..##...#..#.....##....##.#..#......##..#.....#.#.#..#...#####........##.......##..###...#.....#..#..
..#...#.#........#....#.....#...##....#.##..#.#..#...##.##......#.#.###..##............##....##..##.
#....#.##..##.....#.....#...#....#.....#..#......#.####.##.###...#.....###..#.#..#.#.##...##.#..####
..##..#....#...#.#...###.#.....##.....##.#.....#..###...###..#..#.#...#..##..##.........#....#.#...#
.......#.##....#.#.....####..##.##...##..#.#...##....#....#.###...#......##...##.#.#......##.######.
.#..##..#.....#...#..#...#....#.#..#..#.......#.#.#.#.#......#....#...##...#.#.....#..#..##..#.....#
#.#.#..###.#.....###.##.###......#....#.##...#..............#...#.#..#......##...##.##.....####.####
....#.#.#.......#..#..#.#.#.........#....#.#.###.#..#....##........##...#..#..#.....#.###.........#.
..##...........#.#...#.##..#.#....#...#.##..#.......#...##.#...##.....#.....#..#......#..##.#..##.##
.....#.###.#.##..##.###....#..#.....#....#.#..#...#...##...#.....#....#...#.###.###..#..###..#..#...
#...#....###.....#...#.#.#..#..#.#..##....##.#...#..........#...#..#....##...#.#........#......#.###
..#...#...##.#.#.#.#.......###.##.#.#.##.##.##.#.##..#..##.#.###...#.#.#....#####.....#....###.###.#
##....#.#...##...#....#..#.#...##..#.#....#.#.##...##..##..##..#.....#....##.#####.####............#
..#.....##.#..#.##....##..#.##.#...#...#.#.#.####....#.....#.##...#....##.##.###......#.......#.#..#
#.#.###..###...#......##....#.....##.......#.....#..#...##..##.##....#..........#..######..#.##..#..
..#.#.#...#......######.#...#....####..###...#......####...#..#.#.#..##...#.#.....###..##......#.#.#
.###..##..###...#.##.......#..##..##....#...........###...#..........#.............#..#.#..#.##.###.
...###......#.##....#.#...####.#..#....###.#.....#.####....#......#.....#......#........##..###.#...
..#....#...#...#..########.#.#...#....#....#.#.....#.#.......##..#...#.#..#...##.##..#.....####...##
.......##.......#....##.#..#.#.##..#......#.##.#.#.#...#.##......##.#..#..#...#.##..#..#.#.###...###
.##......#..##..###...#....###..#.#.#..#...#....##...#.##.#...#...##..####.##.#...#.....##..........
.....##.....#.#..#.#.###...##........#.#.#.##...#..#...#.#.#...#.#.##.....#.....###...###.....#.....
..#.#......#.....#...#......##.#...###.#.#..#.#....##...##.#...#..#...#..#.##.......#.#.#..#..#.#..#
...##.#.....####...#...###..#..#..###.....#..##...#..##..#........#......#...#...#.#......#.#......#
.#.#..###..#.#.#...####....#........#.#.#.......#.#...##..###.......###.#.#.......#.#...##.#..##....
.......#...#..#......#...#..###....#....##.###.#.#...##..#....#..##.#..#..#.#..#...##.##....##.###..
#..###...#..#.###..#.#.#..##..###.#....#.#....#.#.##.##...####...#####....#.#.##.#.#.#..##...#...#..
#......#.....#..#..#..##...#...###.#.......#...#...#........##......#.##..#...##.......#.#.###..#..#
.#..#...###...#...#.#.................###.##......#.##...#####.#..#...##...#..#.###...##..###.....#.
.....#.##.#.#....#..#......#.....##.....#...#.#.#.....#.........#.#.##..#..####....#.#......##....#.
##.#..#......#..##...#.#.....#.##...#...#####...#...#..#...#..#...#..#.....##....#.##...........#...
...#.#...#..##.#.###..##..#.#.##..............##.##.###........#.#.##.#..#....##....#..#....#....##.
...#...##.....#......#.#........#.......#.###..##.#.#..#.....##.#.....#.#.....##...#.##.##...##...#.
.....##..#...##..#.##.#..#.......##...###.....#..#..#..##......#...#....#....##.....#####.......#.#.
....#..###..........#.......#.##.........###..#....##......#...##...#..#.#...#.###..#####..###.#.##G
